+--------+
|O   #   |
|## *   O|
|#  # *  |
|#* #O* O|
|#O*# # #|
|##t#   #|
|#####* #|
|#####O #|
+--------+
