+------+
|      |
|   O *|
|O   * |
|     O|
|#O#**#|
|t    #|
+------+
2
