+------+
|   ###|
|   ##t|
|#   * |
| *#O  |
|  *  #|
|O##  O|
+------+
5
