+------+
|    ##|
| ## #t|
|# * O*|
|  # # |
|O * * |
|# O  O|
+------+
2
