+------+
|t O   |
|O *   |
|##* ##|
|# * # |
|    # |
| O#   |
+------+
3
