+------+
|Ot  # |
|O #*  |
|  *   |
|   ** |
| O#  #|
| ##O  |
+------+
4
