+------+
|O     |
| *  O |
|  *  #|
| # *#t|
|  O   |
| ###  |
+------+
3
