+------+
|    ##|
| * * O|
|   *  |
|  #O*O|
| OOt**|
|##O   |
+------+
3
