+------+
|   O*t|
|#O * O|
|##*# O|
|#     |
| **#  |
|   O  |
+------+
4
