+------+
|##O O |
|OO ** |
| *    |
| # O  |
|***#  |
|t  #O |
+------+
3
