+------+
| Ot##O|
|  *   |
| * *# |
|#OO * |
|####* |
|##O   |
+------+
4
