+------+
|#O#t  |
|  *O* |
|#   * |
| **##O|
|   ###|
| OO###|
+------+
4
