+------+
|t #   |
| *  O#|
| O O#O|
| O *O*|
| #*** |
|     #|
+------+
4
