+------+
|      |
|*  O*#|
|   O #|
| *#   |
|Ot#   |
|##    |
+------+
2
