+------+
|####t |
|O#O * |
| *O O#|
| *# * |
|      |
|  ### |
+------+
3
