+------+
|  #  O|
|  *   |
|  ##  |
|O*###O|
|**    |
|tO##  |
+------+
2
