+------+
|t  ##O|
| O* * |
|#O *  |
|   #O |
| *OO**|
|      |
+------+
3
