+------+
|  t  #|
|  **##|
|*O  O#|
| *#  #|
|     #|
|     #|
+------+
